a - ad. one; any; each
able - v. having the power to do something
about - adj. almost (“about half”); of or having a relation to(“We talk about the weather.”)
above - ad. at a higher place
abuse - n. bad treatment causing harm or injury
accept - v. to agree to receive
accident - n. something that happens by chance or mistake;an unplanned event
accuse - v. to say a person is responsible for an act or crime;to make a statement against someone
across - ad. from side to side; to the other side
act - v. to do something
activist - n. one who seeks change through action
actor - n. someone acting in a play or show
add - v. to put (something) with another to make it larger; to say more
administration - n. the executive part of a government, usually headed by a president or prime minister
admit - v. to accept (“admitted to the United Nations”); to express one’s guilt or responsibility 
adult - n. a grown person
advertise - v. to show or present the qualities of a product to increase sales
after - ad. later; behind
again - ad. another time; as before
against - ad. opposed to; not agreeing with something
agency - n. an organization that is part of a larger group(“an agency of the United Nations”)
aggression - n. an attack against a person or country; the violation of a country’s borders
ago - ad. of time past; before now
agree - v. to have the same belief as someone; to be willing to do something
agriculture - n. farming
aid - v. to help; to support; n. help, assistance
aim - v. to point a gun at; n. a goal or purpose
air - n. the mixture of gases around the earth, mostly nitrogen and oxygen,that we breathe
air force - n. a military organization using airplanes
airplane - n. a vehicle with wings that flies
airport - n. a place where airplanes take off and land
album - n. a collection of recorded music
alcohol - n. a strong, colorless liquid, usually made from grain, used in drinks or in industrial products
alive - ad. having life; not dead
all - ad. everything; everyone; the complete amount
ally - n. a nation or person joined with another for a special purpose
almost - ad. a little less than completely
alone - ad. separated from others
along - ad. near or on (“along the road”)
already - ad. before now; even now
also - ad. added to; too
although - conj. even if it is true that
always - ad. at all times; every time
ambassador - n. a nation’s highest diplomatic representative (to another government)
amend - v. to add to or to change (a proposal or law)
ammunition - n. the bullets or shells fired from guns
among - ad. in or part of (a group)
amount - n. the number, size or weight of anything
anarchy - n. a lack of order; lawlessness
ancestor - n. a family member from the past
ancient - ad. very old; long ago
and - conj. also; in addition to; with
anger - n. a strong emotion against someone or something
animal - n. a living creature that moves, such as a dog or cat
anniversary - n. a yearly celebration or observance of an event that happened in the past
announce - artillery
another - ad. one more; a different one
answer - n. a statement produced by a question; v. to make a statement after being asked a question
antibodies - n. special proteins produced in the blood that kill harmful bacteria
any - ad. one or more of no special kind
apologize - v. to express regret for a mistake or accident for which one accepts responsibility
appeal - v. to take to a higher court, person or group for a decision; to call on somebody for help
appear - v. to show oneself; to come into sight; to seem
appoint - v. to name; to choose (“appoint a judge”)
approve - v. to agree with; to agree to support
archeology - n. the scientific study of past human life and activities
area - n. any place or part of it
argue - v. to offer reasons for or against something; to dispute; to disagree
arms - n. military equipment; weapons
army - n. military ground forces
around - ad. on every side (of)
arrest - v. to seize a person for legal action; to take as a prisoner
arrive - v. to come to a place, especially at the end of a trip
art - n. expressions or creations by humans, such as paintings, music, writing or statues
artillery - n. big guns
as - available
as - conj. equally (“as fast as”); when; while
ash - n. the part left after something burns
ask - v. to question; to say something is wanted (“We ask the teacher questions every day.”)
assist - v. to help
astronaut - n. a person who travels in space
astronomy - n. the scientific study of stars and the universe
asylum - n. political protection given by a government to a person from another country
at - prep. in or near (“at the edge”); where (“look at”); when(“at noon”)
atmosphere - n. the gases surrounding any star or planet
atom - n. a very small part of all things; the smallest part of an element that can join with parts of other elements
attach - v. to tie together; to connect
attack - n. a violent attempt to damage, injure or kill; v. to start a fight
attempt - v. to work toward something; to try; to make an effort
attend - v. to be present at
attention - n. close or careful observing of, or listening to,someone or something 
automobile - n. a vehicle with wheels used to carry people;a car
autumn - n. the time of the year between summer and winter
baby - n. a newly born creature
back - n. the part behind the front; ad. the other way from forward
bacteria - n. living things that are one cell and can be seen only through a microscope; some cause disease
bad - ad. wrong; acting against the law; not good
balance - v. to make two sides or forces equal
ball - n. something round
balloon - n. a device of strong, light material that rises when filled with gas lighter than air
ballot - n. a piece of paper used for voting
ban - v. to not permit; to stop; n. an official restriction
bank - n. an organization that keeps and lends money
bar - v. to prevent or block
barrier - n. anything that blocks or makes an action difficult
base - n. a military center; v. to establish as a fact
battle - bird
battle - n. a fight between opposing armed forces
be - v. to live; to happen; to exist
beat - v. to hit again and again
beauty - n. that which pleases the eye, ear or spirit
because - prep. for the reason that
become - v. to come to be
bed - n. a sleeping place
before - prep. earlier
begin - v. to do the first part of an action; to start
behavior - n. the way in which a person or animal acts
behind - ad. at the back of; in back of
believe - v. to think; to feel sure of; to accept as true; to trust
belong - v. to be owned by; to be a member of
below - ad. lower than
best - ad. the most good
betray - v. to turn against; to be false to
better - ad. more good than
between - ad. in the space or time that separates; from one to the other (“talks between two nations”)
big - ad. of great size; not small
bill - n. a legislative proposal
biology - n. the scientific study of life or living things in all their forms
bird - n. a creature that flies
bite - v. to cut with the teeth
black - ad. dark; having the color like that of the night sky
blame - v. to accuse; to hold responsible
bleed - v. to lose blood
blind - ad. not able to see
block - v. to stop something from being done; to prevent movement
blood - n. red fluid in the body
blow - v. to move with force, as in air (“The wind blows.”)
blue - ad. having the color like that of a clear sky
boat - n. something built to travel on water that carriespeople or goods
body - n. all of a person or animal; the remains of a person or animal
boil - v. to heat a liquid until it becomes very hot
bomb - n. a device that explodes with great force; v. to attack or destroy with bombs
bone - n. the hard material in the body
book - n. a long written work for reading
border - n. a dividing line between nations
born - v. to come to life; to come into existence
borrow - v. to take as a loan
both - ad. not just one of two, but the two together
bottle - n. a container, usually made of glass, to hold liquid
bottom - burn
bottom - ad. the lowest part of something
box - n. something to put things into; a container, usually made of paper or wood
boy - n. a young male person
boycott - v. to refuse to take part in or deal with
brain - n. the control center of thought, emotions and body activity of all creatures
brave - ad. having no fear
bread - n. a food made from grain
break - v. to divide into parts by force; to destroy
breathe - v. to take air into the body and let it out again
bridge - n. a structure built over a waterway, valley or roadso people and vehicles can cross from one side to the other
brief - ad. short; not long
bright - ad. giving much light; strong and clear in color
bring - v. to come with something
broadcast - v. to send information, stories or music by radioor television; n. a radio or television program
brother - n. a male with the same father or mother as another person
brown - ad. having the color like that of coffee
budget - n. a spending plan
build - v. to join materials together to make something
building - n. anything built for use as a house, factory, office, school, store or place of entertainment
bullet - n. a small piece of metal shot from a gun
bury - v. to put into the ground and cover with earth
bus - n. a public vehicle to carry people
business - n. one’s work; buying and selling to earn money;trade
busy - ad. doing something; very active
but - conj. however; other than; yet
buy - v. to get by paying something, usually money
by - conj. near; at; next to (“by the road”); from (“a play by William Shakespeare”); not later than (“by midnight”)
cabinet - n. a group of ministers that helps lead a government
call - v. to give a name to (“I call myself John.”); to ask for or request (“They called for an end to the fighting.”)
calm - ad. quiet; peaceful; opposite tense
camera - n. a device for taking pictures
camp - n. a place with temporary housing
campaign - n. a competition by opposing political candidates seeking support from voters
can - v. to be able to; to have the right to; n. a container used to hold liquid or food, usually made of metal
cancel - v. to end; to stop
cancer - cell
cancer - n. a disease in which dangerous cells grow quickly and destroy parts of the body
candidate - n. a person who seeks or is nominated for an office or an honor
capital - n. the official center of a government; the city where a country’s government is
capture - v. to make a person or animal a prisoner; to seize or take by force; to get control of
car - n. a vehicle with wheels used to carry people; an automobile; a part of a train
care - v. to like; to protect; to feel worry or interest
career - n. a chosen profession; a person’s working life
case - n. a legal action
case - n. an incident of disease (“There was only one case of chicken pox at the school.”)
cat - n. a small animal that often lives with humans
catch - v. to seize after a chase; to stop and seize with the hands
cause - v. to make happen; n. the thing or person that produces a result
ceasefire - n. a halt in fighting, usually by agreement
celebrate - v. to honor a person or event with special activities
cell - n. a small mass of living material that is part of all plants and animals
center - choose
century - n. one hundred years
ceremony - n. an act or series of acts done in a special way established by tradition
chairman - n. a person leading a meeting or an organized group
champion - n. the best; the winner
chance - n. a possibility of winning or losing or that something will happen
change - v. to make different; to become different
charge - v. to accuse someone of something, usually a crime; n. a statement in which someone is accused of something
chase - v. to run or go after someone or something
cheat - v. to get by a trick; to steal from
cheer - v. to shout approval or praise chemicals - n. elements found in nature or made by people
chemistry - n. the scientific study of substances, what they are made of, how they act under different conditions
chief - n. the head or leader of a group; ad. leading; most important
child - n. a baby; a boy or girl
children - n. more than one child
choose - v. to decide between two or more
chromosome - close
chromosome - n. a line of genes; most human cells contain 46 chromosomes
circle - n. a closed shape that has all its points equally distant from the center, like an “O”
citizen - n. a person who is a member of a country by birth or by law
city - n. any important large town
civilian - ad. not military
civil rights - n. the political, economic and social rights given equally to all people of a nation
claim - v. to say something as a fact
clash - n. a battle; v. to fight or oppose
class - n. a group of students who meet to study the same subject; also a social or economic group.
clean - v. to make pure; ad. free from dirt or harmful substances (“clean water”)
clear - ad. easy to see or see through; easily understood
clergy - n. a body of officials within a religious organization
climate - n. the normal weather conditions of a place
climb - v. to go up or down something by using the feet and sometimes the hands
clock - n. a device that measures and shows time
cloth - n. a material made from plants, chemicals, animal hair and other substances
cloth - committee
clothes - n. what people wear
cloud - n. a mass of fog high in the sky
coal - n. a solid black substance used as fuel
coalition - n. forces, groups or nations joined together
coast - n. land on the edge of the ocean
coffee - n. a drink made from the plant of the same name
cold - ad. not warm; having or feeling great coolness or alow temperature
collapse - v. to fall down or inward suddenly; to break down or fail suddenly in strength, health or power
collect - v. to bring or gather together inone place; to demand and receive (“collect taxes”)
college - n. a small university
colony - n. land controlled by another country or government
color - n. the different effects of light on the eye, making blue, red, brown, black, yellow and others
combine - v. to mix or bring together
come - v. to move toward; to arrive
command - v. to order; to have power over something
comment - v. to say something about; to express an opinion about something
committee - n. a group of people given special work
common - congratulate
common - ad. usual; same for all (“a common purpose”)
communicate - v. to tell; to give or exchange information
community - n. a group of people living together in one place or area
company - n. a business organized for trade, industrial or other purposes
compare - v. to examine what is different or similar
compete - v. to try to do as well as, or better than, another or others
complete - ad. having all parts; ended or finished
complex - ad. of or having many parts that are difficult to understand; not simple
compound - n. a substance containing two or more elements
compromise - n. the settlement of an argument where each side agrees to accept less than first demanded
computer - n. an electronic machine for storing and organizing information, and for communicating with others
concern - n. interest, worry (“express concern about”); v. to fear (“to be concerned”)
condemn - v. to say a person or action is wrong or bad
condition - n. something declared necessary to complete an agreement; a person’s health
conference - n. a meeting
confirm - v. to approve; to say that something is true
conflict - n. a fight; a battle, especially a long one
congratulate - v. to praise a person or to express pleasure for success or good luck
connect - v. to join one thing to another; to unite; to link
conservative - n. one who usually supports tradition and opposes great change
consider - v. to give thought to; to think about carefully constitution 
contact - n. the act of touching or being close to a person or thing 
contain - v. to hold; to include
container - n. a box, bottle or can used to hold something
continent - n. any of the seven great land areas of the world
continue - v. to go on doing or being
control - v. to direct; to have power over
convention - n. a large meeting for a special purpose
cook - v. to heat food before eating it
cool - ad. almost cold
cooperate - v. to act or work together
copy - v. to make something exactly like another; n. something made to look exactly like another
corn - criticize
corn - n. a food grain
correct - ad. true; free from mistakes; v. to change to what is right
corruption - n. actions taken to gain money or power that are legally or morally wrong
cost - n. the price or value of something (“The cost of the book is five dollars.”); v. to be valued at
cotton - n. a material made from a plant of the same name
count - v. to speak or add numbers
country - n. a nation; the territory of a nation; land away from cities
court - n. where trials take place; where judges make decisions about law
cover - v. to put something over a person or thing; n. anything that is put over a person or thing
cow - n. a farm animal used for its milk
crash - v. to fall violently; to hit with great force
create - v. to make; to give life or form to
creature - n. any living being; any animal or human
credit - n. an agreement that payments will be made at a later time
crew - n. a group of people working together
crime - n. an act that violates a law
criminal - n. a person who is responsible for a crime
crisis - n. an extremely important time when something may become much better or worse; a dangerous situation
crops - n. plants that are grown and gathered for food, such as grains, fruits and vegetables
cross - v. to go from one side to another; to go across
crowd - n. a large number of people gathered in one place
crush - v. to damage or destroy by great weight; to defeat completely
cry - v. to express or show sorrow or pain
culture - n. all the beliefs, traditions and arts of a group or population
cure - v. to improve health; to make well 
curfew - n. an order to people to stay off the streets or to close their businesses
current - n. movement of air, water or electricity;ad. belonging to the present time 
custom - n. a long-established belief or activity of a people
customs - n. taxes on imports
cut - v. to divide or injure with a sharp tool; to make less; to reduce
dam - n. a wall built across a river to hold back flowing water
damage - v. to cause injury or destruction; n. harm; hurt or injury, usually to things
dance - degree
dance - v. to move the body and feet to music; n. a series of steps, usually to music
danger - n. a strong chance of suffering injury, damage or loss
dark - ad. having little or no light
date - n. an expression of time; a day, month and year
daughter - n. a person’s female child
day - n. twenty-four hours; the hours of sunlight
dead - ad. not living
deaf - ad. not able to hear
deal - v. to have to do with 
debate - v. to argue for or against something; n. a public discussion or argument
debt - n. something that is owed; the condition of owing
decide - v. to choose; to settle; to judge
declare - v. to say; to make a statement
decrease - v. to make less in size or amount
deep - ad. going far down; a long way from top to bottom
defeat - v. to cause to lose in a battle or struggle; n. a loss; the condition of having lost
defend - v. to guard or fight against attack; to protect
deficit - n. a shortage that results when spending is greater than earnings, or imports are greater than exports
define - v. to give the meaning of; to explain
degree - n. a measure of temperature
delay - v. to decide to do something at a later time; to postpone; to cause to be late
delegate - n. one sent to act for another; one who represents another
demand - v. to ask by ordering; to ask with force democracy 
demonstrate - v. to make a public show of opinions or feelings; to explain by using examples 
denounce - v. to accuse of being wrong or evil; to criticize severely
deny - v. to declare that something is not true; to refuse a request
depend - v. to need help and support
deplore - v. to regret strongly; to express sadness
deploy - v. to move forces or weapons into positions for action
depression - n. severe unhappiness
describe - v. to give a word picture of something; to give details of something
desert - n. a dry area of land
design - v. to plan or create plans for
desire - v. to want very much; to wish for
destroy - v. to break into pieces; to end the existence of
detail - disappear
detail - n. a small part of something; a small piece of information
detain - v. to keep or hold 
develop - v. to grow; to create; to experience progress
device - n. a piece of equipment made for a special purpose
dictator - n. a ruler with complete power
die - v. to become dead; to stop living; to end
diet - n. usual daily food and drink
different - ad. not the same
difficult - ad. not easy; hard to do, make or carry out
dig - v. to make a hole in the ground
dinner - n. the main amount of food eaten at a usual time 
dirt - n. earth or soil
disappear - v. to become unseen; to no longer exist
disarm - v. to take away weapons; to no longer keep weapons
disaster - n. an event causing widespread destruction or loss of life, such as an earthquake or plane crash
discover - v. to find or learn something
discrimination - n. unfair treatment or consideration based on opinions about a whole group 
discuss - v. to talk about; to exchange ideas
disease - n. a sickness in living things, often caused by viruses, germs or bacteria
dismiss - v. to send away; to refuse to consider
dispute - v. to oppose strongly by argument; n. an angry debate
dissident - n. a person who strongly disagrees with his or her government
distance - n. the amount of space between two places or objects 
dive - v. to jump into water head first
divide - v. to separate into two or more parts
do - v. to act; to make an effort
doctor - n. a person trained in medicine to treat sick people
document - n. an official piece of paper with facts written on it, used as proof or support of something
dog - n. a small animal that often lives with humans
dollar - dry
dollar - n. United States money, one hundred cents
donate - v. to present something as a gift to an organization, country or cause. 
door - n. an opening for entering or leaving a building or room
double - v. to increase two times as much in size, strength or number.
down - ad. from higher to lower; in a low place
dream - v. to have a picture or story in the mind during sleep
drink - v. to take liquid into the body through the mouth
drive - v. to control a moving vehicle
drop - v. to fall or let fall; to go lower
drown - v. to die under water
dry - ad. not wet; without rain
during - ad. through the whole time; while (something is happening)
dust - n. pieces of matter so small that they can float in the air
duty - n. one’s job or responsibility; what one must do because it is right and just
each - ad. every one by itself
early - ad. at or near the beginning, especially the beginning of the day; opposite late
earn - v. to be paid in return for work done
earth - n. the planet we all live on; the ground or soil
earthquake - n. a sudden, violent shaking of the earth’s surface
ease - v. to reduce; to make less difficult
east - n. the direction from which the sun rises
easy - ad. not difficult; not hard to do
eat - v. to take food into the body through the mouth
ecology - n. the scientific study of the environment and links among living and material things
economy - n. the system by which money, industry and trade are organized
edge - n. the line where something ends or begins education - n. the act of teaching
effect - n. the result or change caused by something do something
egg - n. the rounded object containing unborn young produced by female birds, fish or reptiles
either - ad. one of two, but not the other
elect - v. to choose by voting
electron - n. a small part of an atom that has an electrical force
electricity - n. a form of energy that flows through wires to provide heat and light, and power to machines
embryo - n. a human or animal in the earliest stages of its development
emergency - n. an unexpected and dangerous situation demanding quick action
emotion - n. a strong feeling such as love, hate, fear or sadness
employ - v. to give work in return for wages
empty - ad. having nothing inside; v. to remove everything
end - v. to stop; to finish; n. the part which comes last
enemy - n. a person opposing or hating another; a person or people of the other side in a war
energy - n. power used to do work, usually with machines; the ability and willingness to be active
engine - n. a machine that uses energy to cause movement or to do work
engineer - n. a person who designs engines, machines, roads, bridges or railroads
enjoy - v. to be pleased or satisfied by something
enough - ad. as much as necessary
enter - v. to come or go into
environment - n. all surrounding things, conditions and influences that affect life
enzyme - n. a special kind of protein; it produces changes in other substances without being changed itself
equal - ad. the same in amount, size, weight or value; having the same rights
equipment - n. things, tools or machines needed for a purpose or activity
escape - v. to get free; to get away from; to get out of
especially - ad. more than others 
establish - v. to bring into existence; to create
estimate - v. to form an opinion about a value, size or amount using less than complete information
ethnic - ad. of or concerning people belonging to a large group because of their race, religion, language, tribe 
evaporate - v. to change from a liquid into a gas
even - ad. in a way not thought possible 
event - n. that which happens, especially something of importance
ever - experience
ever - ad. at any time
every - ad. each one; all
evidence - n. material or facts that prove something; a reason for believing
evil - ad. not good; extremely bad
exact - ad. having no mistakes; correct in every detail
examine - v. to study closely
example - n. a part that shows what the rest of a thing or group is like
excellent - ad. extremely good
except - prep. but for
exchange - v. to trade; to give or receive one thing for another
excuse - v. to take away blame; to pardon; to forgive; n. a reason (sometimes false) for an action
execute - v. to kill
exercise - n. an activity or effort for the purpose of improving the body or to stay in good health
exile - v. to force a person to leave his or her country; to expel
exist - v. to be; to live
expand - v. to make larger; to grow larger
expect - v. to think or believe that something will happen; to wait for an event
expel - v. to force out; to remove from; to send away
experiment - v. to test; n. a test or trial carried out to prove if an idea is true or false, or to discover something
expert - n. a person with special knowledge or training
explain - v. to give reasons for; to make clear; to tell about; to tell the meaning
explode - v. to break apart violently with a loud noise, like a bomb
explore - v. to travel in a place that is not well known to learn more about it; to make a careful search
export - v. to send to another country; n. something sent to another country, usually for sale
express - v. to say clearly
extend - v. to stretch out in area or length; to continue for a longer time
extra - ad. more than normal, expected or necessary
extraordinary - ad. far greater or better than the usual or normal
extreme - ad. more than the usual or accepted
extremist - n. a person with strong religious or political beliefs who acts in an extreme or violent way
fact - feed
fact - n. something known or proved to be true
factory - n. a building or group of buildings where goods made
fail - v. to not succeed; to not reach a goal
fair - ad. just; honest; what is right
fall - v. to go down quickly; to come down; to drop to the ground or a lower position
false - ad. not true; not correct
family - n. the group that includes children and their parents
famous - ad. known very well to many people
fan - n. a person who actively supports a sport, activity or performer 
far - ad. at, to or from a great distance
farm - n. land used to grow crops and animals for food
fast - ad. moving or working at great speed; quick
fat - n. tissue in the bodies of humans and animals used to store energy and to keep warm; ad. thick; heavy
father - n. the male parent; a man who has a child or children
favorite - ad. liked more than others 
fear - v. to be afraid; to worry that something bad is near or may happen 
federal - ad. of or having to do with a national or central government
feel - v. to have or experience an emotion; to know by touching
female - n. a woman or girl; the sex that gives birth; ad. of or about women
fence - n. something around an area of land to keep animals or people in or out
fertile - ad. rich in production of plants or animals; producing much
fetus - n. unborn young
few - ad. not many; a small number of
field - n. an area of open land, usually used to grow crops or to raise animals
fierce - ad. extremely strong; violent; angry
fight - v. to use violence or force; to attempt to defeat or destroy an enemy; n. the use of force; a battle
fill - v. to put or pour something into a container until there is space for no more
film - v. to record something so it can be seen again; to make a motion picture or movie
final - ad. at the end; last
financial - ad. of or about the system that includes the use of money, credit, investments and banks
find - v. to discover or learn something by
fine - n. a payment ordered by a court to punish someone for a crime; ad. very good; very small or thin
finish - fluid
finish - v. to complete; to end
fire - v. to shoot a gun; n. the heat and light produced by something burning
fireworks - n. rockets producing bright fire in the sky, used in holiday celebrations
firm - ad. not easily moved or changed
first - ad. coming before all others
fish - n. a creature that lives and can breathe in water
fission - n. a splitting; in atomic fission, the nucleus of an atom is split to produce nuclear energy
fit - v. to be of the correct size or shape 
fix - v. to make good or right again
flag - n. a piece of colored cloth used to represent a nation, government or organization
flat - ad. smooth; having no high places
flee - v. to run away from
float - v. to be on water without sinking; to move or be moved gently on water or through air
flood - v. to cover with water; n. the movement of water out a river, lake or ocean onto land
floor - n. the bottom part of a room for walking on 
flow - v. to move like a liquid
fly - v. to move through the air with wings, like a bird or airplane; to travel in an airplane or flying vehicle
fog - n. a mass of wet air that is difficult to see through; a cloud close to the ground
follow - v. to come or go after; to accept the rule or power of; to obey
food - n. that which is taken in by all living things for energy, strength and growth
fool - v. to make someone believe something that is not true
foot - n. the bottom part of the leg
for - prep. because of ; through space or time; representative of 
force - v. to make someone do something or make something happen by using power
foreign - ad. of, about or from another nation; not from one’s own place or country
forest - n. a place of many trees
forget - v. to not remember
forgive - v. to pardon; to excuse; to remove guilt
form - v. to make; to start; to shape 
former - ad. earlier in time; not now
forward - future
forward - ad. the direction in front of; toward the front
free - v. to release; ad. not controlled by another or by outside forces; not in prison; independent
freedom - n. the condition of being free
freeze - v. to cause or to become very cold; to make or to become hard by cold
fresh - ad. newly made or gathered; recent
friend - n. a person one likes and trusts
frighten - v. to cause great fear
from - prep. having a person, place or thing as a beginning or cause
front - n. the forward part; the opposite of back; the beginning; the first part
fruit - n. food from trees and plants
fuel - n. any substance burned to create heat or power
full - ad. containing as much as a person or thing can hold; complete
fun - n. anything that is pleasing and causes happiness
funeral - n. a ceremony held in connection with the burial or burning of the dead
fusion - n. a joining together; in atomic fusion, atomic particles are joined together to produce nuclear energy
future - n. time after now 
general - n. a high military leader; ad. without details; affecting or including all or almost all
generation - n. a group of individuals born and living about the same time
genes - n. parts of cells that control the growth and development of living things
genetic engineering - n. the science of changing the genes of a living organism
genocide - n. a plan of action to kill or destroy a national, religious, racial or ethnic group
gentle - adj. soft; kind; not rough or violent
get - v. to receive; to gain; to go and bring back; to become; to become the owner of
gift - n. something given without cost
girl - n. a young female person
give - grind
give - v. to present to another to keep without receiving payment
glass - n. a hard, clear material that is easily broken, used most often for windows or for containers to hold liquids
go - v. to move from one place to another; to leave
goal - n. that toward which an effort is directed
gold - n. a highly valued yellow metal
good - ad. pleasing; helpful; kind; correct; not bad
goods - n. things owned or made to be sold
govern - v. to control; to rule by military or political power
government - n. a system of governing; the organization of people that rules a country, city or area
grain - n. the seed of grass plants used for food, such as wheat, rice and corn; those plants that produce the seeds
grass - n. a plant with long, narrow, green leaves
gravity - n. the force that pulls things toward the center of the Earth
gray - ad. having the color like that made by mixing black and white
great - ad. very large or more than usual in size or number; very good; important
group - n. a number of people or things together; a gathering of people working for a common purpose
grow - v. to develop or become bigger; to increase in size or amount
guarantee - v. to promise a result; to promise that something will happen
guard - v. to watch and protect a person, place or thing
guerrilla - n. a person who fights as part of an unofficial army, usually against an official army or police
guide - v. to lead to; to show the way; n. one who shows the way
guilty - ad. having done something wrong or in violation of a law; responsible for a bad action
gun - n. a weapon that shoots bullets
hair - n. the fine material that grows from the skin, especially from the head
half - n. one of two equal parts of something
halt - v. to come or cause to come to a stop; to stop
hang - v. to place something so the highest part is supported and the lower part is not; to kill by hanging
happen - v. to become a fact or event; to take place
happy - ad. pleased; satisfied; feeling good; not sad
hard - ad. not easily cut or broken; solid; difficult to do or understand; needing much effort or force
harm - v. to injure; to damage; n. damage; hurt
harvest - v. to gather crops; n. the crop after it is gathered
hat - n. a head cover
hate - v. to have strong emotions against; to consider as an enemy; opposite love
have - v. to possess; to own; to hold
he - pro. the boy or man who is being spoken about
head - v. to lead; to command; n. leader; chief; the top part of something; the highest position
headquarters - n. the center from which orders are given; the main offices of a business or organization
heal - v. to return to good health; to cure; to become well
health - n. the general condition of the body and mind; the condition of being free from sickness or disease
hear - v. to receive sound through the ears; to receive news about
heat - v. to make hot or warm; n. great warmth; that which is produced by burning fuel; energy from the sun
heavy - ad. having much weight; not easy to lift; of great amount or force
helicopter - n. a machine without wings that can fly up or down or remain in one place above the ground
help - v. to give support; to assist; to make easier; n. support; aid
here - ad. in, to or at this place
hero - n. a person honored for being brave or wise
hide - v. to prevent from being seen or found; to make secret
high - ad. tall; far up; far above the ground; important; above others
hijack - v. to seize or take control of a vehicle by force
hill - n. a small mountain
history - n. the written record or description of past events; the study of the past
hit - v. to strike; to touch with force
hold - v. to carry or support, usually in the hands or arms
hole - n. an opening; a torn or broken place in something
holiday - n. a day when one does not work; a day on which no work is done to honor or remember a person or event
holy - ad. greatly honored in religion
home - n. the building where a person lives, especially with family
honest - ad. truthful; able to be trusted
honor - v. to obey; to show strong, good feelings for (“to honor one’s parents”);
hope - v. to expect; to believe there is a good chance that something will happen as wanted; to want something to happen
horrible - ad. causing great fear; terrible
horse - n. a large animal often used for racing, riding or farm work
hospital - n. a place where sick or injured people are given medical care
hostage - n. a person captured and held as a guarantee that a demand or promise will be honored
hostile - ad. ready to fight; ready for war
hot - ad. having or feeling great heat or a high temperature
hotel - n. a building with rooms, and often food, for travellers
hour - n. a measure of time; sixty minutes
house - n. a building in which people live; a country’s parliament or lawmaking group (“House of Representatives”)
how - ad. in what way; to what amount
however - conj. yet; but
huge - ad. very big; of great size
human - ad. of or about people
humor - n. the ability to understand, enjoy or express what makes people laugh
hunger - n. the need for food
ice - n. frozen water
idea - n. a thought or picture in the mind; a belief
identify - v. to recognize someone or something and to say who or what they are
if - conj. on condition; provided that 
illegal - ad. not legal; in violation of a law
image - n. a reproduction of the appearance of a person or thing
imagine - v. to make a picture in the mind; to form an idea
immediate - ad. without delay; very near in time or place
immigrant - n. a person who arrives in a country to live there
import - v. to bring from another country; n. something brought from another country, usually for sale
important - ad. having great meaning, value or power
improve - v. to make better; to become better
in - prep. inside; held by; contained by; surrounded by; during
incident - n. an event or something that happens
include - v. to have; to make a part of
increase - v. to make more in size or amount
independent - ad. not influenced by or controlled by another or others; free; separate
individual - n. one person
industry - n. any business that produces goods or provides services
infect - v. to make sick with something that causes disease
inflation - n. a continuing rise in prices while the value of money goes down
influence - v. to have an effect on someone or something; to cause change
inform - v. to tell; to give knowledge to
information - n. knowledge; facts
inject - v. to force a fluid into, such as putting medicine or drugs into the body through the skin
innocent - ad. not guilty of a crime; not responsible for a bad action
insane - ad. mentally sick
insect - n. a very small creature, usually with many legs and sometimes with wings
inspect - v. to look at something carefully; to examine, especially by an expert
instead - ad. in the place of; taking the place of
instrument - n. a tool or device designed to do something or to make something
insult - v. to say something or to do something that makes another person angry or dishonored
intelligence - n. the ability to think or learn; information gathered by spying
intelligent - ad. quick to understand or learn
intense - ad. very strong; extremely serious
interest - n. what is important to someone 
interfere - v. to get in the way of; to work against; to take part in the activities of others
international - ad. of or about more than one nation or many nations; of the whole world
intervene - v. to come between; to come between in order to settle or solve
invade - v. to enter an area or country by force with an army
invent - v. to plan and make something never made before; to create a new thing or way of doing something
investigate - v. to study or examine all information about an event, situation or charge; to search for the truth
invite - v. to ask someone to take part in or join an event, organization or gathering
involve - v. to take part in; to become a part of; to include
iron - n. a strong, hard metal used to make machines and tools
island - n. a land area with water all around it
issue - n. an important problem or subject that people are discussing or arguing about it 
joint - ad. shared by two or more
joke - n. something done or said to cause others to laugh
judge - v. to form an opinion about; to decide a question, especially a legal one
jump - v. to push down on the feet and move up quickly into the air
justice - n. the quality of being right, fair or lawful
keep - v. to possess; to have for oneself
kick - v. to hit with the foot
kidnap - v. to seize and take away by force
kill - v. to make dead; to cause to die
kind - n. sort (“What kind of dog is that?”); ad. gentle; caring; helpful
kiss - v. to touch with the mouth to show love or honor
knife - n. a tool or weapon used to cut
labor - n. work; workers as a group
lack - v. to be without
lake - n. a large area of fresh water surrounded by land
language - n. words and their use; what people speak in a country, nation or group
laser - n. an instrument that makes a thin, powerful light
last - v. to continue
late - ad. after the correct time; near the end; opposite early
laugh - v. to make sounds to express pleasure or happy feelings
launch - v. to put into operation; to begin; to send into the air or space
learn - v. to get knowledge about; to come to know a fact or facts
leave - v. to go away from; to let something stay where it is
left - ad. on the side that is toward the west when one is facing north; opposite right
legal - ad. of or in agreement with the law legislature - n. a government lawmaking group
lend - v. to permit someone to use a thing temporarily; to make a loan of money
less - ad. smaller in amount; not as much
let - v. to permit to do or to be; to make possible
lie - v. to have one’s body on the ground or other surface
life - n. the time between being born and dying; opposite death; all living things
lift - v. to take or bring up to a higher place or level
lightning - n. light produced by electricity in the air, usually during a storm
like - v. to be pleased with; to have good feelings for someone or something; ad. in the same way as; similar to
limit - v. to restrict to a number or amount; n. the greatest amount or number permitted
link - v. to connect; to unite one thing or event with another
liquid - n. a substance that is not a solid or gas, and can move freely, like water
listen - v. to try to hear
literature - n. all the poems, stories and writings of a period of time or of a country
little - ad. not tall or big; a small amount
long - ad. not short; measuring from beginning to end; measuring much; for much time
look - v. to turn the eyes toward so as to see; to search or hunt for; to seem to be
lose - v. to have no longer; to not find; to fail to keep; to be defeated
loud - ad. having a strong sound; full of sound or noise
low - ad. not high or tall; below the normal height; close to the ground
loyal - ad. showing strong friendship and support for someone or something
luck - n. something that happens by chance
magazine - n. a publication of news, stories, pictures or other information
magnet - n. a piece of iron or other material that has a pulling force; this pulling force is called magnetism
mail - material
mail - n. letters, papers and other things sent through an official system, such as a post office
main - ad. the most important or largest
major - ad. great in size, importance or amount
majority - n. the greater number; more than half
male - n. a man or boy; the sex that is the father of children; ad. of or about men
man - n. an adult male human
manufacture - v. to make goods in large amounts
many - ad. a large number or amount of
map - n. a picture of the earth’s surface or a part of it
march - v. to walk in a group like soldiers; to walk together in a large group to protest about something
mark - v. to make a sign or cut on something
marry - v. to join a man and woman together as husband and wife
mass - n. an amount of matter having no special form and usually of a large size
mate - v. to bring together a male and a female to create another creature
matter - n. anything that can be seen or felt; what things aremade of
may - v. a word used with an action word to mean permit
mayor - n. the chief official of a city or town government
meal - n. food eaten to satisfy hunger, such as dinner
mean - v. to want to; to give the idea of; to have the idea of
measure - v. to learn the amount, size or distance of something; n. an action taken; a legislative proposal
meat - n. the part of a dead animal used for food
media - n. all public information organizations, including newspapers, television and radio
meet - v. to come together with someone or something at the same time and place
melt - v. to make a solid into a liquid by heating it
member - n. one of a group
memorial - n. something done or made to honor the memory of a person or event
mental - ad. about or having to do with the mind
message - n. written or spoken news or information; a note from one person to another person or group
middle - n. the center; a place or time of equal distance from both sides or ends
military - n. the armed forces of a nation or group; ad. of or about the armed forces
mind - n. the thinking, feeling part of a person
minor - ad. small in size; of little importance
minority - n. the smaller number; opposite majority
miss - v. to fail to hit, see, reach or meet
missile - n. any weapon that can be thrown or fired through the air and explodes when it reaches its target
missing - ad. lost; not found
mistake - n. a wrong action or decision; an action done without the knowledge that it was wrong
mix - v. to put different things together to make one thing
mob - n. a large group of wild or angry people
model - n. an example; something, usually small, made to show how something will look or work
moderate - ad. not extreme
modern - ad. of the present or very recent time; the most improved
molecule - n. the smallest amount of a chemical substance that can exist
money - n. pieces of metal or paper used to pay for things
month - n. one of the twelve periods of time into which a year is divided
moral - ad. concerning what is right or wrong in someone’s actions
more - ad. greater in size or amount
morning - n. the early part of the day, from sunrise until noon
most - narrow
most - ad. greatest in size or amount
mother - n. the female parent; a woman who has a child or children
motion - n. a movement; a continuing change of position or place
mountain - n. a part of the earth’s surface that rises high above the area around it
mourn - v. to express or feel sadness
move - v. to change position; to put or keep in motion; to go
movement - n. the act of moving or a way of moving; a series of acts or efforts to reach a goal
movie - n. a motion picture; a film
much - ad. great in amount
murder - v. to kill another person illegally; n. the crime of killing another person
music - n. the making of sounds by singing or using a musical instrument
must - v. a word used with an action word to mean
nation - n. a country, together with its social and political systems
native - n. someone who was born in a place, not one who moved there
natural - ad. of or about nature; normal; common to its kind
nature - n. all the plants, animals and other things on earth not created by humans
navy - n. the part of a country’s military force trained to fight at sea
near - ad. not far; close to
necessary - ad. needed to get a result or effect; required
need - v. to require; to want; to be necessary to have or to do
negotiate - v. to talk about a problem or situation to find a common solution
neighbor - n. a person or country that is next to or near another
neither - ad. not one or the other of two
nerve - n. a thin piece of tissue that sends information through the body to and from the brain
neutral - ad. not supporting one side or the other
new - ad. not existing before; not known before; recently made, built, bought or grown; another; different
news - n. information about any recent events, especially as reported by the media
next - ad. coming immediately after; nearest
nice - ad. pleasing; good; kind
night - n. the time between when the sun goes down and when it rises, when there is little or no light
no - ad. used to reject or to refuse; not any; not at all
noise - n. sound, especially when loud
normal - n. the usual condition, amount or form; ad. usual; what is expected
north - n. the direction to the left of a person facing the rising sun
not - ad. a word showing that something is denied or untrue 
note - v. to talk about something already known; n. a word or words written to help a person remember; a short letter
nothing - n. not anything; no thing
now - ad. at this time; immediately
nowhere - ad. not in, to or at any place 
obey - v. to act as one is ordered to act
object - v. to show that one does not like or approve; to protest
observe - v. to watch; to look at carefully; to celebrate or honor something 
occupy - v. to take and hold or to control by force
ocean - n. the area of salt water that covers almost seventy-five percent of the earth’s surface
of - prep. made from; belonging to; about; connected to; included among
off - ad. away; at a distance; condition when something is no longer operating or continuing
offensive - n. a military campaign of attack; ad. having to do with attacking
offer - v. to present or propose; n. the act of presenting or
often - ad. many times
oil - n. a thick liquid that does not mix with water and that burns easily
old - ad. not young or new; having lived or existed for many years
on - prep. above and held up by; touching the upper surface of 
once - ad. one time only
only - ad. being the single one or ones; no more than
open - v. to start 
operate - v. to do work or a job; to cut into the body for medical reasons
opinion - n. a belief based on one’s own ideas and thinking
oppose - v. to be against; to fight against
organ - n. a part of the body that has a special purpose, such as the heart or brain
organism - n. a living thing, often so small it can be seen only through a microscope
our - ad. of or belonging to us
oust - v. to force to leave; to remove by force
out - ad. away from the inside; opposite of in
pain - n. a hurt or suffering somewhere in the body
paint - v. to cover with a liquid color; to make a picture with liquid colors
paper - n. a thin, flat material made from plants or cloth often used for writing
parachute - n. a device that permits a person or thing to fall slowly from an airplane or helicopter to the ground
parade - n. a group of people and vehicles moving together to celebrate a special event or anniversary
pardon - v. to forgive for a crime and release from punishment
parent - n. a father or mother
parliament - n. a government lawmaking group
part - n. something less than the whole; not all of something
particle - n. a very small piece of matter
partner - n. a person who takes part in some activity in common with another or others. 
pass - v. to go by or move around something; to move along; to cause or permit to go
past - n. the time gone by; the time before; ad. recent; immediately before; former
path - n. a narrow way for walking; a way along which something moves
patient - n. a person being treated by a doctor for a health problem
people - n. any group of persons; all the persons of a group, race, religion or nation
perform - v. to speak, dance or sing in front of others
period - n. an amount of time within events, restrictions or conditions permanent 
permit - v. to let; to make possible
person - n. a man, woman or child
physical - ad. of the body
physics - n. the study of motion, matter and energy
picture - n. something that shows what another thing looks like
piece - n. a part of something larger
pig - n. a farm animal usedfor its meat
pilot - n. one who guides or flies an airplane
place - v. to put something somewhere; n. an area or a part of an area
plan - v. to organize or develop an idea or method of acting or doing something 
planet - n. a large object in space that orbits the sun
plant - v. to put into the ground to grow
please - v. to make one happy; to give enjoyment
plenty - n. all that is needed; a large enough amount
plot - v. to make secret plans; n. a secret plan to do something wrong or illegal
poem - n. words and their sounds organized in a special way to express emotions
point - v. to aim one’s finger toward; to aim; n. the sharp end of something
politics - n. the activities of government and of those who are in public office
pollute - v. to release dangerous or unpleasant substances into the air, soil or water
postpone - v. to delay action until a later time
pour - v. to flow; to cause to flow
poverty - n. the condition of being poor
pray - v. to make a request to a god or spirit
president - n. the chief official of a country that is a republic
press - v. to urge strongly; n. newspapers, magazines and other publications
prevent - v. to keep or stop from going or happening
produce - v. to make; to create; to cause something to be
profession - n. a job that requires special training
professor - n. a teacher at a college or university
profit - n. money gained from a business activity after paying all costs of that activity
progress - n. movement forward or toward improvement or a goal
project - n. a planned effort to do something
promise - v. to say one will do something; n. a spoken or written agreement to do something
propaganda - n. ideas or information used to influence opinions
property - n. anything owned by someone such as land, buildings or goods
propose - v. to present or offer for consideration
protect - v. to guard; to defend; to prevent from being harmed or damaged
provide - v. to give something needed or wanted
put - v. to place; to set in position
question - v. to ask; to express wonder or disbelief
quick - ad. fast
radiation - n. waves of energy from something that produces heat or light 
railroad - n. a road for trains; a company that operates such a road and its stations and equipment
rain - n. water falling from the sky
rare - ad. not common; not usual; not often
rate - n. speed; a measure of how quickly or how often something happens
reach - v. to put a hand toward; to arrive at; to come to
ready - ad. prepared; completed; organized; willing
real - ad. true; truly existing; not false
realistic - ad. in agreement with the way things are
reason - n. the cause for a belief or act; purpose; something that explains
reasonable - ad. ready to listen to reasons or ideas; not extreme; ready or willing to compromise
recent - ad. a short time ago
recession - n. a temporary reduction in economic activity, when industries produce less and many workers lose their jobs
record - v. to write something in order to have it for future use
refuse - v. to reject; to not accept, give or do something
regret - n. a feeling of sadness or sorrow about something that is done or that happens
reject - v. to refuse to accept, use or believe
relations - n. understandings or ties between nations
release - v. to free; to permit to go
religion - n. a belief in, or the honoring of, a god or gods
remain - v. to stay in a place after others leave
remains - n. a dead body
remember - v. to think about the past; opposite forget
remove - v. to take away or take off; to put an end to; to take out of a position or office
repair - n. work done to fix something
repeat - v. to say or do again
repress - v. to control or to restrict freedoms by force
request - v. to ask for; n. the act of asking for
require - v. to need or demand as necessary
resist - v. to oppose; to fight to prevent
responsible - ad. having a duty or job to do 
rest - v. to sit, lie down or sleep to regain strength
restaurant - n. a place where people can buy and eat meals
retire - v. to leave a job or position because one is old or in poor health
revolt - v. to protest violently; to fight for a change, especially of government
rice - n. a food grain
rich - ad. having much money or goods; having plenty of something
right - n. what a person legally and morally should be able to do or have 
riot - v. to act with many others in a violent way in a public place
rise - v. to go up
risk - n. the chance of loss, damage or injury
rob - v. to take money or property secretly or by force; to steal
robot - n. a machine that moves and performs work
rock - n. a hard piece of mineral matter
root - n. the part of a plant that is under the ground and takes nutrients from the soil
rope - n. a long, thick piece of material made from thinner pieces of material, used for tying
rough - ad. not flat or smooth; having an uneven surface
round - ad. having the shape
ruin - satisfy
ruin - v. to damage severely; to destroy
rule - v. to govern or control; to decide
run - v. to move quickly by steps faster than those used for walking
rural - ad. describing areas away from cities which may include farms, small towns and unpopulated areas.
sad - ad. not happy
safe - ad. away from harm or danger
sail - v. to travel by boat or ship
sailor - n. a person involved in sailing a boat or ship
salt - n. a white substance found in sea water and in the ground, used to affect the taste of food
same - ad. not different; not changed; like another or others
sand - n. extremely small pieces of crushed rock found in large amounts in deserts and on coasts
say - v. to speak; to express in words
school - n. a place for education; a place where people go to learn
sea - n. a large area of salt water, usually part of an ocean
search - v. to look for carefully
secret - n. something known only to a few and kept from general knowledge
security - n. freedom from danger or harm; protection
see - v. to know or sense through the eyes; to understand or know
seed - n. the part of a plant from which new plants grow
seem - v. to appear to be 
self - n. all that which makes one person different from others
sell - v. to give something in exchange for money
senate - n. the smaller of the two groups in the governments of some countries, such as in the United States Congress
send - v. to cause to go; to permit to go; to cause to be carried, taken or directed to or away from a place
sense - v. to come to know about by feeling, believing or understanding
serve - v. to work as an official
settle - v. to end (a dispute); to agree about (a problem); to make a home in a new place
several - ad. three or more, but not many
shake - v. to move or cause to move in short, quick movements
shape - v. to give form to; n. the form of something, especially how it looks
sharp - ad. having a thin edge or small point that can cut or hurt
she - pro. the girl or woman who is being spoken about
shine - v. to aim a light; to give bright light; to be bright; to clean to make bright
ship - v. to transport; n. a large boat
shock - v. to cause to feel sudden surprise or fear
shoe - n. a covering for the foot
shout - v. to speak very loudly
shrink - v. to make or become less in size, weight or value
sick - ad. suffering physically or mentally with a disease or other problem; not in good health
sickness - n. the condition of being in bad health
silence - v. to make quiet; to stop from speaking or making noise
silver - n. a valued white metal
similar - ad. like something else but not exactly the same
sing - v. to make music sounds with the voice
single - ad. one only
sink - v. to go down into water or other liquid
skill - n. the ability gained from training or experience
skin - n. the outer covering of humans and most animals
sky - soldier
sky - n. the space above the earth
slave - n. a person owned or controlled by another
sleep - v. to rest the body and mind with the eyes closed
slide - v. to move smoothly over a surface
slow - v. to reduce the speed of; ad. not fast in moving, talking or other activities
small - ad. little in size or amount; few in number; not important; opposite large
smash - v. to break or be broken into small pieces by force; to hit or move with force
smooth - ad. having a level surface; opposite rough
snow - n. soft, white pieces of frozen water that fall from the sky
some - ad. of an amount or number or part not stated; not all
son - n. a person’s male child
soon - ad. not long after the present time; quickly
sort - n. any group of people or things that are the same or are similar in some way
speak - v. to talk; to say words with the mouth
speech - n. a talk given to a group of people
split - v. to separate into two or more parts; to divide or break into parts
sport - n. any game or activity of competition involving physical effort or skill
spread - v. to become longer or wider; to make or become widely known
spring - n. the time of the year between winter and summer
start - v. to begin; to make something begin
starve - v. to suffer or die from a lack of food
state - v. to say; to declare; n. a political part of a nation
steal - v. to take without permission or paying
steam - n. the gas that comes from hot water
stone - n. a small piece of rock
stove - n. a heating device used for cooking
straight - ad. continuing in one direction without turns
strange - sudden
strange - ad. unusual; not normal; not known
street - n. a road in a city, town or village
stretch - v. to extend for a distance; to pull on to make longer or wider
submarine - n. an underwater ship
succeed - v. to reach a goal or thing desired; to produce a planned result
suicide - n. the act of killing oneself
surprise - sympathy
survive - v. to remain alive during or after a dangerous situation
sympathy - n. a sharing of feelings or emotions with another person, usually feelings of sadness
tall - ad. higher than others; opposite short
target - n. any person or object aimed at or fired at
taste - v. to sense through the mouth (“The fruit tastes sweet.”)
technology - n. the use of scientific knowledge and methods to produce goods and services
telephone - n. a device or system for sending sounds, especially the voice, over distances
tell - v. to give information; to make known by speaking; to order; to command
temperature - n. the measurement of heat and cold
temporary - ad. lasting only a short time
tense - ad. having fear or concern; dangerous; opposite calm
term - n. a limited period of time during which someone does a job or carries out a responsibility
terrible - ad. very bad; causing terror or fear
territory - n. a large area of land
terror - n. extreme fear; that which causes great fear
terrorist - n. a person who carries out acts of extreme violence as a protest or a way to influence a government
these - time
these - pro. of or about the people, places or things nearby that have been spoken about already
they - pro. those ones being spoken about
thick - ad. having a large distance between two opposite surfaces
think - v. to produce thoughts; to form ideas in the mind; to consider; to believe
third - ad. coming after two others
threaten - v. to warn that one will do harm or cause damage
tired - ad. having less strength because of work or exercise; needing sleep or rest
today - n. this day
together - ad. in one group; at the same time or place; in cooperation
tomorrow - n. the day after today
tonight - n. this night
too - ad. also; as well as; more than is necessary
tool - n. any instrument or device designed to help one do work
top - n. the upper edge or surface; the highest part; the cover of something
total - n. the complete amount
touch - v. to put the hand or fingers on
toward - prep. in the direction of; leading to
town - n. a center where people live, larger than a village but not as large as a city
tragic - ad. extremely sad; terrible
trap - v. to catch or be caught by being tricked; to be unable to move or escape; n. a device used to catch animals
travel - v. to go from one place to another, usually for a long distance
treason - n. the act of fighting against one’s own country or of helping its enemies
treasure - n. a large collection of money, jewels or other things of great value
truce - n. a temporary halt in fighting agreed to by all sides involved
truck - n. a heavy vehicle used to carry goods
true - ad. correct; not false
trust - v. to believe that someone is honest and will not cause harm
try - v. to make an effort
turn - v. to change direction
unite - v. to join together
universe - n. all of space, including planets and stars
until - conj. up to a time; before
up - ad. to, in or at a higher position or value
urge - v. to advise strongly; to make a great effort to get someone to do something
urgent - ad. needing an immediate decision or action
us - pro. the form of the word “we” used after a preposition
valley - n. a long area of land between higher areas of land
version - n. the form of something with different details than earlier or later forms
very - ad. extremely (“He was very late.”)
veto - v. to reject or refuse to approve
victim - n. someone or something that is injured, killed or made to suffer; someone who is tricked
village - n. a very small town
violate - v. to fail to obey or honor; to break (an agreement)
virus - n. a kind of organism that causes disease
wages - n. money received for work done
wait - v. to delay acting; to postpone
walk - v. to move by putting one foot in front of the other
want - v. to desire; to wish for; to need
war - n. fighting between nations, or groups in a nation, using weapons
warm - ad. almost hot; having or feeling some heat
warn - v. to tell of possible danger; to advise or inform about something bad that may happen
wash - v. to make clean, usually with water
wear - v. to have on the body, as clothes
weather - n. the condition of the atmosphere resulting from sun,
weigh - v. to measure how heavy someone or something is
welcome - v. to express happiness or pleasure when someone arrives or something develops
well - ad. in a way that is good or pleasing; in good health
west - n. the direction in which the sun goes down
wet - ad. covered with water or other liquid; not dry
wheat - n. a grain used to make bread
whether - conj. if it be the case or fact that 
wife - n. a woman who is married
will - v. a word used with action words to show future action 
wind - n. a strong movement of air
wood - n. the solid material of which trees are made
word - n. one or more connected sounds that form a single part of a language
world - n. the earth; the people who live on the earth
worry - v. to be concerned; to continue thinking that something, possibly bad, can happen
worse - ad. more bad than
worth - n. value measured in money
wound - v. to injure; to hurt; to cause physical damage to a
x ray - n. a kind of radiation that can pass through most solid material, often used in medicine
year - n. a period of time equal to twelve months
yellow - ad. having the color like that of gold or the sun
yes - ad. used to express agreement or to permit
zero - n. the number meaning none or nothing
zoo - n. a place where animals are kept for the public to look at and study
avant garde - n. new and experimental ideas in art, music and literature
afraid - ad. feeling fear
age - n. how old a person or thing is
bewilderment - n. the feeling of being perplexed or confused
cherish - v. protect or care for lovingly
affect - v. to produce an effect on; to influence
draft - n. a written order to pay a specified sum
tumour - n. a swelling of any kind
cliche - n. a stereotype or electrotype
